%%%%%%%%%%%%%%%%%%%%%
%........%......... %
%.%%%%%.%..%%.%%%%. %
%.....%....%.....%. %
%.%%%%%.%%.%%%%%.%. %
%.%.....G....P....%.%
%.%.%%%....%%%....%.%
%...%....%%%%%....%.%
%........%%%%%%....%%
%.........%.........%
%%%%%%%%%%%%%%%%%%%%%
